R 1200 840
NO textures/redbrick.xpm
SO textures/green_tex.xpm
WE textures/new_xpm.xpm
EA textures/write_tex.xpm
S textures/barrel.xpm
K textures/pillar.xpm
F textures/floor.xpm
C textures/ceiling.xpm

111111111111111111111111111111111   11111
111111111110000000000200000000001   122N1
113000000000000000000000000000011   13301
111111111110000000000000000000001   11111
113000000000000000000000000000001
113000000000000000000000000000001
1130000000000010000000000000000021
111111111110000000000000111111111
110011111110000000000000000000021
111011111100000000000000000000001
111111100000020000200100000000021
111111111111111111111111111111111