R 1070 840
NO textures/redbrick.xpm
SO textures/green_tex.xpm
WE textures/new_xpm.xpm
EA textures/write_tex.xpm
S textures/barrel.xpm
K textures/pillar.xpm
F textures/floor.xpm
C textures/ceiling.xpm

11111111111111111111111111111
10000000001100000000000021111
10110000000003000002000000111
1001000000010000S000000001111
11111011000100011111000000001
10000300001100011111000000001
11110000000111000101100111011
11110000000111000101010010001
11000000110101001100000010001
10002000000000001100000000001
10000000003000000001010000301
11000001110101011111011110111
11110111 1110101 101111010001
11111111 1111111 111111111111