R 1050 750
NO textures/onetttt.xpm
SO textures/redbrick.xpm
WE textures/purplestone.xpm
EA textures/greystone.xpm
S textures/barrel.xpm
K textures/pillar.xpm
F textures/greystone.xpm
C textures/greystone.xpm


111111111111111111111111111111111
111111111000000000110000000000001
111111111011000001110000002000001
111111111001000000000000000000001
111111111011000001110001111111111
100000000011000001110111111111111
111101111111110111000000100011111
111101111111110111010100100011111
110000001101010111000000100011111
100020000000000011000000100011111
100000000000000011010100100011111
11000001110101011111011110N011111
111101111111010111011110100011111
111111111111111111111111111111111