R 1050 750
NO textures/onetttt.xpm
SO textures/redbrick.xpm
WE textures/purplestone.xpm
EA textures/greystone.xpm
S textures/barrel.xpm
K textures/pillar.xpm
F textures/greystone.xpm
C textures/greystone.xpm

    11111111111111111111111111111
    11100000000211000000000000111
    11111011000001110000000000001
    10010000000000000000000011111
111111111011000001110000000010001
100000000011000001110111111111111
11110111111111011100000010001
11110111111111011101010010001
11000000112121011100000010001
10000000000000000111000010201
1E0000000000000011 1010010001
100000000000000011 1010010001
1100000011012121111121111000111
11112111 1112121 101111010001
11111111 1111111 111111111111